You wake up to the slow pitter-patter of oil colliding against the surface of cold concrete. Instantly you are hit with a pressure in your chest. There is a sinking feeling as an ominous vibe surrounds you.

game
An Interactive Fiction by kgoodrowe20
Release 1 / Serial number 190215 / Inform 7 build 6M62 (I6/v6.33 lib 6/12N) SD

Garage
You are within a dimly lit room, cluttered with various shelves of junk. There is a run-down red muscle car sitting in the corner. The paint has started to chip and rust is beginning to pop up on its body.

There is a doorway to the east, with a faint glow being emitted from it.

>e
Kitchen
This room has a familiar, but unpleasant smell. The linoleum floors have a slight shimmer to them as the dim light coming from the ceiling lamp hits it. There is an empty oven which sits next to where a fridge should be. Two cabinets decorate the walls, but one appears to have the handles ripped off of the doors.

>open cabinet
You open the cabinet.

* * *

>e
Kitchen
This room has a familiar, but unpleasant smell. The linoleum floors have a slight shimmer to them as the dim light coming from the ceiling lamp hits it. There is an empty oven which sits next to where a fridge should be. Two cabinets decorate the walls, but one appears to have the handles ripped off of the doors.

>w
Garage
You find yourself within a dimly lit room, cluttered with various shelves of junk. There is a run-down red muscle car sitting in the corner. The paint has started to chip and rust is beginning to pop up on its body.

There is a doorway to the east, with a faint glow being emitted from it.

* * *

>enter car
You can't get into the closed car.

>take chipped paint
Taken.

>e
Kitchen
This room has a familiar, but unpleasant smell. The linoleum floors have a slight shimmer to them as the dim light coming from the ceiling lamp hits it. There is an empty oven which sits next to where a fridge should be. Two cabinets decorate the walls, but one appears to have the handles ripped off of the doors.

* * *

>open cabinet
You open the cabinet.

>cut web
Cutting it up would achieve little.

>cut web with chipped paint
I only understood you as far as wanting to cut web.

>take key
You can't see any such thing.

>x web
The web must've been left alone for a long, long time in order to have grown to the massive size that it is, taking up the entire cabinet. It is a wonder how you didn't see it spilling out of the cabinet.

>open web
It seems to be locked.

>unlock web with chipped paint
You unlock web.

>cut web
Cutting it up would achieve little.

>open web
You open web, revealing a key.

>take key
Taken.

>w
Garage
You are within a dimly lit room, cluttered with various shelves of junk. There is a run-down red muscle car sitting in the corner. The paint has started to chip and rust is beginning to pop up on its body.

There is a doorway to the east, with a faint glow being emitted from it.

>unlock car
What do you want to unlock the car with?

>unlock car with key
You unlock the car.

>enter car
You can't get into the closed car.

>open car
You open the car, revealing a bomb.

>enter car
You get into the car.

In the car you can see a bomb.

>take bomb
Taken.

* * *

>inspect car
That's not a verb I recognise.

>look at car
You see nothing special about the car.

>look at shelves
You can't see any such thing.

>e
Kitchen
This room has a familiar, but unpleasant smell. The linoleum floors have a slight shimmer to them as the dim light coming from the ceiling lamp hits it. There is an empty oven which sits next to where a fridge should be. Two cabinets decorate the walls, but one appears to have the handles ripped off of the doors.

>open oven
You can't see any such thing.

>x oven
You can't see any such thing.

>x cabinets
You can't see any such thing.

>x ceiling lamp
You can't see any such thing.

>x fridge
You can't see any such thing.

>x cabinet
Inside the cabinet is bundles upon bundles of spiderwebs. Through the spools of pure white, you see a glimmer of something.

>x something
You can't see any such thing.

>take spiderwebs
You can't see any such thing.

>w
Garage
You are within a dimly lit room, cluttered with various shelves of junk. There is a run-down red muscle car sitting in the corner. The paint has started to chip and rust is beginning to pop up on its body.

There is a doorway to the east, with a faint glow being emitted from it.

>x shelf
You can't see any such thing.

>e
Kitchen
This room has a familiar, but unpleasant smell. The linoleum floors have a slight shimmer to them as the dim light coming from the ceiling lamp hits it. There is an empty oven which sits next to where a fridge should be. Two cabinets decorate the walls, but one appears to have the handles ripped off of the doors.

>x floor
You can't see any such thing.

>w
Garage
You are within a dimly lit room, cluttered with various shelves of junk. There is a run-down red muscle car sitting in the corner. The paint has started to chip and rust is beginning to pop up on its body.

There is a doorway to the east, with a faint glow being emitted from it.

>x shelves
You can't see any such thing.

>x muscle car
You can't see any such thing.

>x run-down red muscle car
You can't see any such thing.

>x car
You see nothing special about the car.

>look at car
You see nothing special about the car.

* * *

>l
Garage
You wake up to the slow pitter-patter of oil colliding against the surface of cold concrete. You find yourself within a dimly lit room, cluttered with various shelves of junk. There is a run-down red muscle car sitting in the corner. The paint has started to chip and rust is beginning to pop up on its body.

There is a doorway to the east, with a faint glow being emitted from it.

* * *

>ok
That's not a verb I recognise.

>dance
That's not a verb I recognise.

>run
You'll have to say which compass direction to go in.

>walk
You'll have to say which compass direction to go in.

>run west
You can't go that way.

>run forwards
You can't see any such thing.

>run backwards
You can't see any such thing.

>run east
Kitchen
This room has a familiar, but unpleasant smell. The linoleum floors have a slight shimmer to them as the dim light coming from the ceiling lamp hits it. There is an empty oven which sits next to where a fridge should be. Two cabinets decorate the walls, but one appears to have the handles ripped off of the doors.

>jump
You jump on the spot.

>die
That's not a verb I recognise.

>eat
What do you want to eat?

>food
You can't see any such thing.

* * *

>take chipped
Taken.

>w
You can't go that way.

>e
Kitchen
This room has a familiar, but unpleasant smell. The linoleum floors have a slight shimmer to them as the dim light coming from the ceiling lamp hits it. There is an empty oven which sits next to where a fridge should be. Two cabinets decorate the walls, but one appears to have the handles ripped off of the doors.

* * *

>take chipped paint
Taken.

* * *

>open cabinet
You open the cabinet.

>x cabinet
Inside the cabinet is bundles upon bundles of spiderwebs. Through the spools of pure white, you see a glimmer of something.

>open web
It seems to be locked.

>unlock web
(with the chipped paint)
You unlock web.

>take key
You can't see any such thing.

* * *

>x cabinet
Inside the cabinet is bundles upon bundles of spiderwebs. Through the spools of pure white, you see a glimmer of something.

>unlock web with chipped paint
You unlock web.

>open web
You open web, revealing a key.

* * *

>unlock car with key
You unlock the car.

>enter car
That's not something you can enter.

* * *

>take chipped paint
Taken.

>w
You can't go that way.

* * *

>cut web
Cutting it up would achieve little.

>open web
It seems to be locked.

* * *

>take key
Taken.

>x key
A car key with what looks like a scratched off logo.

>e
Kitchen
This room has a familiar, but unpleasant smell. The linoleum floors have a slight shimmer to them as the dim light coming from the ceiling lamp hits it. There is an oven which sits next to where a fridge should be. Two cabinets decorate the walls, but one appears to have the handles ripped off of the doors.

* * *

>x car
The red paint on this car appears to have almost completely changed color. The chipped paint is sharp and firm, and it looks like you could possibly cut things with it.

>take chipped paint
That's hardly portable.

* * *

>x car
The red paint on this car appears to have almost completely changed color. The chipped paint is sharp and firm, and it looks like you could possibly cut things with it.

>x windmill
You can't see any such thing.